1111111111111111111111111
1000C0000000C000000000001
1000110000011100C00011101
1P00100E1100000q111000001
100000100000C111000C00001
1111111111111111111111111