1111111111111111111111111
1000000000000000000000001
1000110000011100000011101
1P00100011E0000q111000001
1000001000000111000000001
1111111111111111100111111