NO ./textures/blue.xpm
SO ./textures/green.xpm
WE ./textures/cream.xpm
EA ./textures/grey.xpm

F 213, 196, 229
C 251, 236, 187

        1111111111111111111111111
        1000000000110000000000001
        1011000001110000000000001
        1001000000000000000000001
111111111011000001110000000000001
100000000011000001110111111111111
111101111111110111000000100011
1111011111111101110000110010001
110000000001010111N00000100011
1000000000000000000000110001
1000000000000001101010010001
1100000111010101111101111000111
11110111 1110101 101111010001
11111111 11111111 111111111111
