1111111111
10000C0001
1000111001
1P011111E1
1111111111