1111111111
10000C0001
1000111001
1P00C000E1
1111111111