11111111111111111111
1000C0000000C0000001
1000110000011100C001
1P00100E110000001101
100000100000C1110001
11111111111111111111